 *   ******
   *      *
 * * ***  *
 * *  **  *
*  *   *  *
******  * *
 * *   *  *
     * ****
* ** *   **
* *  * *  /
*/*********